鿓	鿒
錒	锕
鎄	锿
捱	挨
皚	皑
藹	蔼
靄	霭
愛	爱
薆	𫉁
噯	嗳
嬡	嫒
璦	瑷
𣜬	𪳗
曖	暧
礙	碍
𥴨	𫂖
鑀	锿
𩣑	䯃
諳	谙
闇	暗
鮟	𩽾
鵪	鹌
垵	埯
銨	铵
䬓	𫗊
骯	肮
鷔	𪉑
鰲	鳌
媼	媪
襖	袄
奧	奥
嶴	岙
謸	𫍵
驁	骜
八濛山	八濛山
釟	𫓥
𩚥	𩠀
䰾	鲃
䶕	𫜨
軷	𫐈
颰	𩙥
罷	罢
鮁	鲅
𣞻	𣘓
䆉	𫁂
壩	坝
擺	摆
襬	摆
拜覆	拜复
敗	败
𤁣	𣺽
韛	𫖔
頒	颁
𪄕	𪉒
阪	阪
鈑	钣
闆	板
絆	绊
辦	办
幫	帮
綁	绑
縍	𫄰
謗	谤
鎊	镑
𩦠	𫠌
齙	龅
飽	饱
鴇	鸨
寶	宝
報	报
鉋	铇
鮑	鲍
盃	杯
鵯	鹎
䎱	䎬
䥯	𫔆
鉳	锫
貝	贝
狽	狈
㛝	𫝦
珼	𫞥
梖	𪱷
備	备
輩	辈
鋇	钡
憊	惫
𨭎	𬭳
唄	呗
賁	贲
錛	锛
𩣺	𩧼
閍	𨸂
綳	绷
繃	绷
𦅈	𫄵
𩗴	𫗉
鏰	镚
䫾	𫠈
鎞	𫔇
䮠	𩧿
鰏	鲾
筆	笔
㻶	𪼋
畢	毕
畢昇	毕昇
閉	闭
䋔	𫄞
詖	诐
蓽	荜
嗶	哔
鉍	铋
飶	𫗣
彃	𪪼
𣯴	𣭤
幣	币
熚	𤇹
潷	滗
篳	筚
鮅	𫚑
䟆	𫎳
蹕	跸
斃	毙
韠	𫖒
贔	赑
𨯅	䥿
鷩	𫜁
鸊	䴙
編	编
獱	㺍
邊	边
鯾	𫚣
鯿	鳊
籩	笾
貶	贬
閞	𫔰
緶	缏
辮	辫
辯	辩
變	变
變徵	变徵
颮	飑
標	标
颷	𩙪
鏢	镖
驃	骠
飆	飙
飈	飚
鑣	镳
驫	骉
錶	表
鰾	鳔
䳤	𫛮
鱉	鳖
別	别
癟	瘪
彆	别
賓	宾
儐	傧
濱	滨
璸	瑸
檳	槟
瀕	濒
繽	缤
鑌	镔
擯	摈
殯	殡
臏	膑
髕	髌
鬢	鬓
稟	禀
稟覆	禀复
餅	饼
𩶁	𫚎
𩏂	𫖓
併	并
並	并
剝	剥
缽	钵
鉢	钵
撥	拨
餑	饽
蹳	𫏆
驋	𩧯
鈸	钹
鉑	铂
駁	驳
𩗀	𩙦
鮊	鲌
𩗓	𫗈
襏	袯
鵓	鹁
鎛	镈
餺	馎
䌟	𦈞
蔔	卜
鈽	钸
轐	𫐗
補	补
佈	布
鈈	钚
餔	𫗦
𩻗	𫚨
財	财
纔	才
採	采
寀	采
綵	彩
埰	采
叄	叁
參	参
飱	飧
嵾	㟥
㜗	𡞋
䟃	𫎺
驂	骖
殘	残
慚	惭
㨻	𪮃
蠶	蚕
慘	惨
黲	黪
燦	灿
倉	仓
蒼	苍
獊	𪺷
滄	沧
艙	舱
鶬	鸧
𩞄	𩠎
冊	册
厠	厕
側	侧
萴	荝
廁	厕
測	测
惻	恻
𦆲	𫟇
層	层
驓	𫘯
鍤	锸
鎈	𫟿
餷	馇
査	查
鑔	镲
奼	姹
詫	诧
釵	钗
儕	侪
蠆	虿
覘	觇
摻	掺
攙	搀
嬋	婵
禪	禅
蟬	蝉
𨬖	𫔏
纏	缠
讒	谗
鑱	镵
饞	馋
㹽	𫞣
產	产
産	产
剷	铲
嵼	𡶴
滻	浐
𩒎	𫖭
蕆	蒇
幝	𪩷
諂	谄
繟	𦈎
鏟	铲
譂	𫟠
闡	阐
囅	冁
剗	刬
懺	忏
顫	颤
倀	伥
閶	阊
錩	锠
鯧	鲳
䱽	䲝
長	长
萇	苌
場	场
腸	肠
嘗	尝
䗅	𫊪
䠆	𫏃
嚐	尝
償	偿
鱨	鲿
廠	厂
悵	怅
暢	畅
畼	𪽈
鈔	钞
朝乾夕惕	朝乾夕惕
鼂	鼌
麨	𪎊
車	车
唓	𪠳
硨	砗
𥿊	𦈈
徹	彻
𦾟	𦶻
賝	𫎩
陳	陈
蔯	𫈟
塵	尘
諶	谌
鷐	𫜀
磣	碜
𨮳	𫔒
齔	龀
儭	𠋆
櫬	榇
襯	衬
䞋	𫎪
讖	谶
傖	伧
䞓	𫎭
稱	称
撐	撑
赬	赪
檉	柽
蟶	蛏
𩞦	𩠏
棖	枨
誠	诚
𧶔	𧹓
鋮	铖
𩤙	𩨆
懲	惩
騁	骋
喫	吃
絺	𫄨
鴟	鸱
𧒯	𫊹
癡	痴
彲	彨
馳	驰
遲	迟
恥	耻
齒	齿
飭	饬
𩿪	𪉄
熾	炽
𪀦	𪉅
𧩼	𫍶
鶒	𫛶
沖	冲
衝	冲
𩰀	𩬤
緟	𫟆
蟲	虫
寵	宠
銃	铳
紬	䌷
篘	𥬠
綢	绸
儔	俦
薵	䓓
幬	帱
懤	㤽
嬦	𫝩
㦞	𪫷
疇	畴
㿧	𤽯
籌	筹
籌畫	筹划
躊	踌
讎	雠
䲖	𩾂
醜	丑
出醜狼藉	出丑狼借
貙	䝙
齣	出
芻	刍
蒭	𫇴
媰	㛀
䅳	𫀬
鋤	锄
廚	厨
𩔑	𫖷
雛	雏
櫥	橱
躕	蹰
𪆷	𫛾
儲	储
礎	础
齭	𫜭
處	处
絀	绌
觸	触
𡃕	𠴛
傳	传
釧	钏
摐	𪭢
瘡	疮
牀	床
闖	闯
創	创
愴	怆
錘	锤
鎚	锤
鰆	䲠
純	纯
脣	唇
蒓	莼
鶉	鹑
賰	䞐
䮞	𩨁
綽	绰
輟	辍
嚽	𪢕
齪	龊
詞	词
鴜	𪉈
蠀	𧏗
辭	辞
鶿	鹚
鷀	鹚
㓨	刾
賜	赐
囪	囱
蔥	葱
蓯	苁
䢨	𨑹
瑽	𪻐
樅	枞
聰	聪
𥖲	𪿞
鏦	𫓩
驄	骢
從	从
誴	𫟡
叢	丛
𩀨	𫕚
湊	凑
輳	辏
縬	𦈚
䥄	𫠀
顣	𫖹
𪓰	𫜟
攛	撺
躥	蹿
鑹	镩
欑	𪴙
竄	窜
鹺	鹾
銼	锉
錯	错
墶	垯
噠	哒
䌋	𦈘
鎝	𨱏
達	达
答覆	答复
薘	荙
䃮	鿎
繨	𫄤
鐽	𫟼
𩟐	𩠅
韃	鞑
大目乾連冥間救母變文	大目乾连冥间救母变文
躂	跶
獃	呆
軑	轪
帶	带
紿	绐
貸	贷
靆	叇
單	单
鄲	郸
殫	殚
癉	瘅
簞	箪
𨢿	𨡙
撣	掸
擔	担
膽	胆
訑	𫍙
誕	诞
𧩙	䜥
憚	惮
彈	弹
贉	𫎫
當	当
噹	当
璫	珰
𥢷	𫀮
襠	裆
簹	筜
鐺	铛
擋	挡
檔	档
黨	党
灙	𣺼
欓	𣗋
讜	谠
碭	砀
蕩	荡
蕩覆	荡复
壋	垱
盪	荡
魛	鱽
島	岛
搗	捣
導	导
隯	陦
𢷬	𢭏
擣	捣
嶹	𫝵
禱	祷
盜	盗
𤘀	𪺣
䊭	𥺅
鍀	锝
燈	灯
鄧	邓
鐙	镫
磾	䃅
鍉	𫔂
滌	涤
敵	敌
鏑	镝
糴	籴
牴	牴
牴觸	抵触
牴牾	抵牾
詆	诋
遞	递
締	缔
諦	谛
螮	䗖
顛	颠
顛乾倒坤	颠乾倒坤
𩥄	𩨋
巔	巅
癲	癫
點	点
電	电
電覆	电复
鈿	钿
墊	垫
澱	淀
彫	雕
琱	雕
貂覆額	貂复额
鵰	雕
鯛	鲷
弔	吊
𥾯	𫄝
釣	钓
銱	铞
調	调
窵	窎
絰	绖
𨴗	𨸅
諜	谍
鰈	鲽
疊	叠
釘	钉
頂	顶
訂	订
飣	饤
鋌	铤
錠	锭
𩜦	𩠆
丟	丢
銩	铥
東	东
倲	㑈
埬	𪣆
崬	岽
氭	𣱝
鼕	冬
鶇	鸫
凍	冻
動	动
棟	栋
腖	胨
駧	𩧲
鬥	斗
閗	𫔯
餖	饾
竇	窦
闍	阇
獨	独
瀆	渎
嬻	𪥿
瓄	𪻨
櫝	椟
殰	㱩
犢	犊
牘	牍
讀	读
黷	黩
賭	赌
篤	笃
篤麼	笃麽
鍍	镀
緞	缎
鍛	锻
鍛鍾	锻锺
斷	断
籪	簖
𨇰	𫏞
䭔	𫗰
兌	兑
隊	队
綐	䌼
對	对
濧	㳔
懟	怼
噸	吨
燉	炖
鐓	镦
躉	趸
鈍	钝
頓	顿
敓	敚
奪	夺
凙	𪞝
鮵	𫚛
𪃒	𫛻
鐸	铎
綞	缍
䫂	𫖰
嚲	亸
飿	饳
墮	堕
訛	讹
鈋	𨱂
鋨	锇
鵝	鹅
額	额
噁	恶
堊	垩
軛	轭
惡	恶
餓	饿
諤	谔
鍔	锷
顎	颚
鶚	鹗
鰐	鳄
㩵	擜
齶	腭
鱷	鳄
兒	儿
鴯	鸸
鮞	鲕
䋙	䌺
爾	尔
鉺	铒
餌	饵
邇	迩
貳	贰
發	发
發覆	发复
廢	废
閥	阀
罰	罚
鍅	钫
琺	珐
髮	发
釩	钒
煩	烦
䋦	𫄩
樊於期	樊於期
礬	矾
鐇	𫔍
䮳	𩨏
䫶	𫖺
反反覆覆	反反复复
反覆	反复
氾	泛
汎	泛
販	贩
飯	饭
軬	𫐊
範	范
鈁	钫
魴	鲂
紡	纺
訪	访
鶭	𫛯
飛	飞
緋	绯
鯡	鲱
誹	诽
𦃄	𦈗
費	费
曊	𪰶
櫠	𪲮
𦘧	𡳒
鐨	镄
䉬	𫂈
紛	纷
訜	𫍛
鈖	𫟴
魵	𫚍
羵	𫅗
豶	豮
鐼	𫔁
僨	偾
墳	坟
幩	𪩸
憤	愤
奮	奋
膹	𪱥
糞	粪
鱝	鲼
風	风
峯	峰
偑	㐽
楓	枫
碸	砜
瘋	疯
鋒	锋
豐	丰
灃	沣
麷	𫜑
馮	冯
渢	沨
縫	缝
諷	讽
鳳	凤
賵	赗
鴀	𫛜
鈇	𫓧
麩	麸
膚	肤
𩵩	𩽺
麬	𤿲
𦒀	𫅥
彿	佛
鳬	凫
紱	绂
紼	绋
絥	𫄢
鳧	凫
韍	韨
鴔	𫛡
䋹	䌿
輻	辐
鮄	𫚒
襆	幞
鵩	𫛳
輔	辅
撫	抚
負	负
訃	讣
婦	妇
復	复
複	复
駙	驸
賦	赋
𩵹	𩽻
緮	𫄭
鮒	鲋
縛	缚
賻	赙
覆	覆
覆按	复按
覆杯	复杯
覆瓿	复瓿
覆成	复成
覆呈	复呈
覆幬	复帱
覆電	复电
覆鼎	复鼎
覆醢	复醢
覆醬瓿	复酱瓿
覆蕉尋鹿	复蕉寻鹿
覆鹿尋蕉	复鹿寻蕉
覆鹿遺蕉	复鹿遗蕉
覆露	复露
覆冒	复冒
覆命	复命
覆墓	复墓
覆逆	复逆
覆上	复上
覆文	复文
覆校	复校
覆信	复信
覆盂	复盂
覆育	复育
覆帳	复帐
覆住	复住
覆宗	复宗
鰒	鳆
𨰥	𫔕
賅	赅
該	该
𨪕	𫓮
𨮂	𨱕
鈣	钙
蓋	盖
𩚵	𩠁
尷	尴
𩴵	𩴌
桿	杆
稈	秆
趕	赶
鱤	鳡
紺	绀
幹	干
榦	干
贛	赣
岡	冈
剛	刚
𦱌	𫇪
崗	岗
棡	㭎
碙	𥐻
綱	纲
鋼	钢
掆	㧏
槓	杠
睪	睾
𪔵	𪔭
縞	缟
鎬	镐
誥	诰
鋯	锆
擱	搁
鴿	鸽
鎶	鿔
閤	合
閣	阁
鮯	𫚗
鎘	镉
韚	𫠅
騔	𩨀
嗰	𠮶
個	个
箇	个
鉻	铬
給	给
䫀	𫖱
亙	亘
揯	搄
𨄣	𨀱
賡	赓
鶊	鹒
綆	绠
鯁	鲠
宮	宫
碽	䂵
龔	龚
鞏	巩
𥨐	𥧂
貢	贡
𡟫	𫝪
贑	𫎬
鈎	钩
鉤	钩
溝	沟
緱	缑
韝	鞲
夠	够
䝭	𫎧
詬	诟
構	构
覯	觏
購	购
𨇞	𨅫
軲	轱
鈲	𨱃
鴣	鸪
鮕	𩾀
轂	毂
詁	诂
鈷	钴
穀	谷
縎	𦈔
餶	馉
鶻	鹘
蠱	蛊
僱	雇
錮	锢
鯝	鲴
顧	顾
顧藉	顾借
煱	㶽
鴰	鸹
騧	䯄
剮	剐
掛	挂
詿	诖
枴	拐
柺	拐
𢶒	𪭯
噲	哙
關	关
鰥	鳏
觀	观
輨	𫐑
舘	馆
館	馆
𩠴	𩠠
䲘	鳤
貫	贯
摜	掼
慣	惯
鏆	𨱌
鸛	鹳
輄	𨐈
𩅙	𫕨
廣	广
獷	犷
規	规
媯	妫
閨	闺
槼	椝
嬀	妫
璝	𪻺
龜	龟
鮭	鲑
歸	归
鬹	鬶
䲅	𫚜
軌	轨
匭	匦
詭	诡
𥵊	𥭉
貴	贵
槶	椢
劌	刿
劊	刽
瞶	瞆
簂	𫂆
櫃	柜
襘	𫋻
䞈	𧹑
鱖	鳜
袞	衮
滾	滚
緄	绲
輥	辊
緷	𦈉
鯀	鲧
𤳷	𪽝
郭子乾	郭子乾
楇	𣒌
鈛	𫓨
嘓	啯
濄	㳡
鍋	锅
𨽏	𨸘
蟈	蝈
國	国
摑	掴
幗	帼
槨	椁
餜	馃
過	过
鉿	铪
還	还
駭	骇
頇	顸
魽	𫠐
函覆	函复
韓	韩
闞	阚
㘚	㘎
閈	闬
馯	𫘛
漢	汉
頷	颔
駻	𫘣
絎	绗
頏	颃
蠔	蚝
號	号
顥	颢
灝	灏
訶	诃
紇	纥
閡	阂
頜	颌
㗿	𪡛
𨨛	𫓼
魺	鲄
齕	龁
闔	阖
覈	核
鑉	𫠁
賀	贺
鶡	鹖
鶴	鹤
𨭆	𬭶
𥽖	𥺇
恆	恒
橫	横
鴴	鸻
䬝	𩙯
輷	𫐒
轟	轰
紅	红
紘	纮
葒	荭
閎	闳
綋	𫟄
鉷	𫟹
魟	𫚉
鴻	鸿
黌	黉
嗊	唝
訌	讧
鬨	哄
餱	糇
䳧	𫛺
後	后
鮜	鲘
鱟	鲎
軤	轷
𧦝	𫍞
狐藉虎威	狐借虎威
壺	壶
𩚩	𫗡
衚	胡
餬	糊
鵠	鹄
鬍	胡
鶘	鹕
鶦	𫛷
許	许
滸	浒
鯱	𩾇
戶	户
䊺	𫄚
𨥛	𨱀
滬	沪
嚛	𪠸
護	护
鸌	鹱
鱯	鳠
華	华
滑藉	滑借
嘩	哗
㠏	㟆
鏵	铧
驊	骅
鷨	𪉊
畫	画
話	话
畵	画
樺	桦
劃	划
諣	𫍩
澅	𣶩
嫿	婳
𩸄	𫚝
懷	怀
壞	坏
鴅	𫛝
歡	欢
絙	𫄠
環	环
鍰	锾
繯	缳
闤	阛
瓛	𤩽
䴉	鹮
䴋	𫜅
緩	缓
奐	奂
換	换
喚	唤
渙	涣
煥	焕
瘓	痪
鯇	鲩
鯶	𩽼
黄鍾公	黄锺公
黃	黄
鍠	锽
餭	𫗮
騜	𫘩
鐄	𨱑
鰉	鳇
謊	谎
揮	挥
媈	𫝨
暉	晖
詼	诙
煇	𪸩
輝	辉
噅	𠯠
翬	翚
回覆	回复
迴	回
鮰	𫚔
毀	毁
燬	毁
譭	毁
匯	汇
賄	贿
會	会
滙	汇
彙	汇
誨	诲
薈	荟
殨	㱮
噦	哕
獩	𤞃
諱	讳
澮	浍
璯	㻅
檜	桧
燴	烩
穢	秽
繢	缋
翽	翙
繪	绘
闠	阓
靧	𫖃
葷	荤
閽	阍
㑮	𫝈
堚	𪣒
渾	浑
琿	珲
餛	馄
䮝	𩧰
諢	诨
䫟	𫖲
鍃	锪
鈥	钬
夥	伙
貨	货
禍	祸
㗲	𠵾
膕	腘
㦎	𢛯
獲	获
穫	获
鑊	镬
𨯟	𫔓
飢	饥
𨊻	𨐆
銈	𫓯
賫	赍
嘰	叽
緝	缉
璣	玑
機	机
積	积
錤	𫓹
䕤	𫟕
擊	击
磯	矶
𧝞	䘛
櫅	𪲎
雞	鸡
譏	讥
饑	饥
躋	跻
鷄	鸡
齎	赍
齏	齑
羈	羁
卽	即
級	级
極	极
輯	辑
藉	藉
藉草枕塊	借草枕块
藉詞	借词
藉此	借此
藉代	借代
藉讀	借读
藉端	借端
藉方	借方
藉槁	借槁
藉故	借故
藉卉	借卉
藉機	借机
藉藉	借借
藉據	借据
藉口	借口
藉寇兵	借寇兵
藉甚	借甚
藉手	借手
藉條	借条
藉以	借以
藉由	借由
藉喻	借喻
藉着	借着
藉助	借助
藉箸代籌	借箸代筹
藉資	借资
鶺	鹡
覿	觌
幾	几
魢	鱾
颳	刮
擠	挤
蟣	虮
䍤	𫅅
計	计
計畫	计划
紀	纪
記	记
旣	既
勣	𪟝
跡	迹
際	际
誋	𫍪
薊	蓟
劑	剂
襀	𫌀
鮆	𫚖
覬	觊
濟	济
績	绩
璾	𫞦
檵	𪲛
蹟	迹
鯽	鲫
繫	系
𩥉	𩧱
繼	继
𨣧	𨠨
霽	霁
鱭	鲚
驥	骥
浹	浃
傢	家
傢俱	家具
筴	䇲
鴐	𫛤
鎵	镓
夾	夹
郟	郏
莢	荚
脥	𣍰
𥞵	𥞦
蛺	蛱
餄	饸
鋏	铗
𩛩	𩠃
頰	颊
鵊	𫛥
賈	贾
鉀	钾
檟	槚
價	价
駕	驾
駱	骆
戔	戋
姦	奸
堅	坚
間	间
監	监
箋	笺
蕳	𫈉
樫	㭴
緘	缄
㔋	𪟎
縑	缣
艱	艰
𣝕	𣘷
殲	歼
鰹	鲣
韉	鞯
梘	枧
揀	拣
䅐	𫀨
減	减
筧	笕
戩	戬
𨧜	䦁
儉	俭
撿	捡
錽	𫓸
檢	检
襇	裥
襉	裥
繭	茧
礆	硷
瞼	睑
簡	简
𦢈	𣍨
謭	谫
鹹	咸
鐗	锏
騫	骞
籛	篯
譾	谫
𩟗	𫗚
鹼	碱
見	见
見覆	见复
𤷃	𪽭
漸	渐
賤	贱
踐	践
劍	剑
澗	涧
薦	荐
鍵	键
餞	饯
諫	谏
𧽯	𫎸
濺	溅
艦	舰
鐧	锏
聻	𫆏
鑒	鉴
鑑	鉴
𨰲	𫔃
將	将
漿	浆
薑	姜
殭	僵
螿	螀
繮	缰
韁	缰
鱂	鳉
蔣	蒋
奬	奖
槳	桨
獎	奖
講	讲
絳	绛
醬	酱
𩝽	𫗳
敎	教
膠	胶
澆	浇
憢	𢙒
嬌	娇
鮫	鲛
轇	𫐖
𨶲	𨸋
鐎	𨱓
驕	骄
鷦	鹪
糹	纟
角徵	角徵
絞	绞
腳	脚
僥	侥
鉸	铰
鉸鍊	铰链
餃	饺
撟	挢
矯	矫
蟜	𫊸
䚩	𫌯
譑	𫍤
繳	缴
攪	搅
較	较
轎	轿
階	阶
嚌	哜
癤	疖
訐	讦
䀹	𥅴
傑	杰
結	结
節	节
詰	诘
𦀖	𫄦
潔	洁
𩢴	𩧵
鮚	鲒
𪀾	𪉋
䌖	𦈜
屆	届
𩡺	𩧦
誡	诫
𪙏	𫜯
金鍊	金链
金吒	金吒
釒	钅
紟	𫄛
璡	琎
䌝	𦈟
巹	卺
僅	仅
緊	紧
儘	尽
錦	锦
謹	谨
饉	馑
勁	劲
晉	晋
進	进
盡	尽
縉	缙
壗	𡋤
藎	荩
濜	浕
覲	觐
燼	烬
贐	赆
䫴	𩖗
荊	荆
莖	茎
涇	泾
經	经
鯨	鲸
驚	惊
剄	刭
頸	颈
頸鍊	颈链
俓	𠇹
陘	陉
逕	迳
徑	径
凈	净
弳	弪
桱	𣐕
脛	胫
淨	净
葝	𫈎
痙	痉
䝼	䞍
靜	静
𩰹	𩰰
鏡	镜
競	竞
駫	𫘡
絅	䌹
熲	颎
糺	𫄙
糾	纠
鳩	鸠
𤳸	𤳄
鬮	阄
𩏷	𫃗
酒逢知己千鍾少	酒逢知己千锺少
廄	厩
舊	旧
欍	𣐤
鷲	鹫
俥	伡
駒	驹
䝻	𧹕
侷	局
鋦	锔
駶	𩧺
鶪	䴗
榘	矩
舉	举
櫸	榉
齟	龃
欅	榉
詎	讵
鉅	巨
鉅防	钜防
鉅萬	钜万
鉅子	钜子
寠	𪧘
劇	剧
據	据
鋸	锯
窶	窭
颶	飓
屨	屦
貗	𫎌
懼	惧
鋗	𫓶
𪌭	𫜓
鵑	鹃
鎸	镌
鐫	镌
捲	卷
錈	锩
雋	隽
絹	绢
𩜇	𩠉
撧	𪮖
屩	𪨗
決	决
訣	诀
絶	绝
絕	绝
駃	𫘝
蕝	𫈵
鴃	𫛞
𥖅	𥐯
譎	谲
鶌	𫛵
覺	觉
鐝	镢
鐍	𫔎
灍	𫞝
钁	镢
軍	军
鈞	钧
鈞覆	钧复
銁	𫓲
皸	皲
鮶	鲪
儁	俊
餕	馂
駿	骏
開	开
䤤	𫟺
鐦	锎
剴	剀
凱	凯
塏	垲
愷	恺
鍇	锴
闓	闿
鎧	铠
愾	忾
龕	龛
檻	槛
轗	𫐘
康乾	康乾
鱇	𩾌
閌	闶
鈧	钪
銬	铐
鮳	鲓
軻	轲
痾	疴
鈳	钶
頦	颏
𨍰	𫐔
顆	颗
殻	壳
剋	克
課	课
緙	缂
錁	锞
騍	骒
墾	垦
懇	恳
硜	硁
䡩	𫟥
鏗	铿
剾	𠛅
摳	抠
瞘	眍
釦	扣
𩑔	𫖪
𧷎	𪠀
𪍠	𫜕
庫	库
絝	绔
褲	裤
嚳	喾
誇	夸
擓	㧟
塊	块
儈	侩
鄶	郐
獪	狯
膾	脍
𥢶	𫞷
䯤	𩩈
鱠	鲙
寬	宽
髖	髋
䥗	𫔋
𦧺	𫇘
誆	诓
誑	诳
鵟	𫛭
儣	𠆲
況	况
貺	贶
鄺	邝
壙	圹
曠	旷
礦	矿
纊	纩
𨇁	𧿈
窺	窥
虧	亏
騤	骙
䳫	𫛼
頍	𫠆
匱	匮
蕢	蒉
嘳	𪡞
潰	溃
憒	愦
嬇	𫝬
謉	𫍷
䙡	䙌
聵	聩
簣	篑
𨣈	𨡺
饋	馈
巋	岿
崑	昆
褌	裈
瑻	𪻲
錕	锟
騉	𫘥
臗	𣎑
鵾	鹍
鯤	鲲
壼	壸
綑	捆
閫	阃
睏	困
𠠎	𠚳
擴	扩
闊	阔
鬠	𫘽
拉鍊	拉链
𩤲	𩨉
臘	腊
蠟	蜡
鑞	镴
來	来
倈	俫
萊	莱
崍	崃
徠	徕
淶	涞
婡	𫝫
棶	梾
𨂐	𫏌
𧳟	𧳕
錸	铼
顂	𩓋
麳	𪎌
𨰋	𫓳
勑	𠡠
睞	睐
賚	赉
誺	𫍧
賴	赖
𡃄	𪡺
攋	𪮶
𡃤	𪢐
瀨	濑
癩	癞
襰	𧝝
籟	籁
嵐	岚
藍	蓝
闌	阑
璼	𫞨
襤	褴
攔	拦
蘭	兰
㘓	𪢌
籃	篮
瀾	澜
繿	䍀
欄	栏
斕	斓
襴	襕
囒	𪢠
灡	㳕
躝	𨅬
讕	谰
鑭	镧
壈	𡒄
㩜	㨫
懶	懒
𢤿	𪬯
孄	𫝮
覽	览
攬	揽
欖	榄
纜	缆
濫	滥
爛	烂
閬	阆
鋃	锒
𩛡	𫗨
鎯	𨱍
𩳤	𩲒
撈	捞
勞	劳
嘮	唠
嶗	崂
𤩂	𫞧
𤛮	𤙯
朥	𦛨
癆	痨
鐒	铹
銠	铑
澇	涝
橯	𣓿
耮	耢
鰳	鳓
餎	饹
縲	缧
鐳	镭
轠	𫐙
虆	蔂
誄	诔
壘	垒
纍	累
淚	泪
類	类
纇	颣
稜	棱
犛	牦
縭	缡
釐	厘
離	离
鯬	𫚞
蘺	蓠
灕	漓
孋	㛤
䍦	䍠
籬	篱
纚	𫄥
驪	骊
鸝	鹂
鱺	鲡
李鍊福	李链福
李乾德	李乾德
李澤鉅	李泽钜
李鍾郁	李锺郁
裡	里
裏	里
鋰	锂
禮	礼
鯉	鲤
邐	逦
欐	𪲔
鱧	鳢
厤	历
蒞	莅
鉝	𫟷
慄	栗
厲	厉
綟	𫄫
㯤	𣘐
𨞺	𫟫
勵	励
歷	历
曆	历
𩶘	䲞
鴗	𫁡
𩣫	𩧸
隸	隶
癘	疠
濿	𪵱
爄	𤇃
壢	坜
藶	苈
櫟	栎
麗	丽
礪	砺
嚦	呖
瀝	沥
𢤩	𪫡
櫪	枥
礫	砾
蠣	蛎
糲	粝
鷅	𫛽
酈	郦
儷	俪
癧	疬
轢	轹
䍽	𦍠
䟐	𫎱
轣	𫐆
靂	雳
連	连
蓮	莲
嗹	𪡏
漣	涟
奩	奁
憐	怜
褳	裢
𦔖	𫅼
縺	𦈐
聯	联
鎌	镰
䭑	𫗱
簾	帘
鐮	镰
鰱	鲢
璉	琏
槤	梿
斂	敛
臉	脸
襝	裣
蘞	蔹
煉	炼
練	练
𧡴	𫌫
殮	殓
鍊	炼
鍊錘	链锤
鍊鎖	链锁
鍊條	链条
鍊形	链形
鍊墜	链坠
鍊子	链子
鏈	链
𧸘	𫎨
瀲	潋
戀	恋
涼	凉
綡	𫟅
樑	梁
輬	辌
糧	粮
𦣎	𦟗
兩	两
倆	俩
掚	𪭵
啢	唡
魎	魉
靚	靓
輛	辆
諒	谅
鍄	𨱉
遼	辽
療	疗
繚	缭
鷯	鹩
釕	钌
瞭	瞭
瞭解	了解
瞭然	了然
瞭如	了如
瞭若指掌	了若指掌
鐐	镣
𥪂	𥩺
𩢾	𩧮
鴷	䴕
鮤	𫚓
獵	猎
𩧆	𩨐
鱲	𫚭
鄰	邻
臨	临
轔	辚
壣	𪤚
鱗	鳞
凜	凛
廩	廪
懍	懔
檁	檩
賃	赁
閵	𫔴
藺	蔺
躪	躏
躪藉	躏借
凌藉	凌借
淩	凌
軨	𫐉
閝	𫠂
鈴	铃
綾	绫
錂	𨱋
鴒	鸰
𩭙	𩬣
鯪	鲮
齡	龄
櫺	棂
靈	灵
䖅	𫟑
𤫩	㻏
欞	棂
爧	𫞠
領	领
嶺	岭
流徵	流徵
劉	刘
鎦	镏
餾	馏
瀏	浏
鏐	镠
飀	飗
騮	骝
鶹	鹠
綹	绺
鋶	锍
鷚	鹨
龍	龙
蘢	茏
嚨	咙
瀧	泷
瓏	珑
櫳	栊
曨	昽
朧	胧
爖	𤇭
矓	眬
礱	砻
龓	𫜲
籠	笼
𦪽	𦨩
聾	聋
𨏠	𨐇
躘	𨀁
䪊	𫖅
䮾	𩧪
鸗	𫛟
隴	陇
壠	垅
攏	拢
徿	𪫌
壟	垄
𢤱	𢘙
贚	𫎦
瞜	䁖
婁	娄
僂	偻
蔞	蒌
遱	𫐷
嘍	喽
㺏	𤠋
慺	㥪
樓	楼
膢	𦝼
熡	𤋏
耬	耧
螻	蝼
謱	𫍴
髏	髅
䮫	𩨇
塿	𪣻
摟	搂
㟺	𪩇
嶁	嵝
漊	溇
簍	篓
瘻	瘘
瘺	瘘
鏤	镂
𨫒	𨱐
擼	撸
嚕	噜
盧	卢
壚	垆
蘆	芦
嚧	𠰷
廬	庐
瀘	泸
櫨	栌
臚	胪
爐	炉
矑	𪾦
㿖	𪽮
蠦	𫊮
艫	舻
轤	轳
鑪	𬬻
顱	颅
鸕	鸬
鱸	鲈
鹵	卤
虜	虏
滷	卤
魯	鲁
擄	掳
磠	硵
瀂	澛
櫓	橹
艣	𫇛
鐪	𫓺
鑥	镥
彔	录
陸	陆
淥	渌
祿	禄
輅	辂
賂	赂
録	录
錄	录
騄	𫘧
轆	辘
騼	𫠋
露覆	露复
籙	箓
鷺	鹭
氌	氇
巒	峦
孿	孪
孌	娈
欒	栾
攣	挛
臠	脔
圞	𪢮
灤	滦
鑾	銮
𨈌	𨄄
鸞	鸾
亂	乱
擽	㧰
掄	抡
侖	仑
倫	伦
菕	芲
㖮	𪠵
崙	仑
圇	囵
淪	沦
㷍	𤆢
綸	纶
輪	轮
錀	𬬭
論	论
腡	脶
羅	罗
鏍	镙
騾	骡
覼	𫌨
儸	㑩
蘿	萝
邏	逻
玀	猡
𤄷	𪶒
欏	椤
籮	箩
鑼	锣
饠	𫗩
絡	络
犖	荦
𠏢	𠉗
濼	泺
𨇽	𫏑
囉	啰
閭	闾
櫚	榈
曥	𣆐
驢	驴
呂	吕
侶	侣
鋁	铝
屢	屡
㜢	𡞱
𡡎	𡞱
褸	褛
縷	缕
穭	穞
緑	绿
綠	绿
慮	虑
繂	𫄴
濾	滤
鋝	锊
媽	妈
嗎	吗
馬	马
傌	㐷
獁	犸
瑪	玛
碼	码
螞	蚂
鎷	𨰾
榪	杩
禡	祃
罵	骂
駡	骂
𢠼	𢙑
買	买
買臣覆水	买臣复水
蕒	荬
嘪	𪡃
脈	脉
麥	麦
勱	劢
嘜	唛
賣	卖
邁	迈
霢	霡
顢	颟
樠	𣗊
瞞	瞒
饅	馒
鰻	鳗
蠻	蛮
滿	满
蟎	螨
縵	缦
謾	谩
鏝	镘
鋩	铓
貓	猫
氂	牦
錨	锚
鉚	铆
䋃	𫄜
貿	贸
么麽	幺麽
么麼	幺麽
麽	么
麼	么
麼些族	麽些族
沒	没
鋂	镅
鎇	镅
𪃏	𪉏
鶥	鹛
黴	霉
鎂	镁
門	门
捫	扪
璊	𫞩
𣯩	𣯣
鍆	钔
悶	闷
燜	焖
懣	懑
們	们
鄳	𫑡
濛	蒙
懞	蒙
矇	蒙
鸏	鹲
錳	锰
夢	梦
謎	谜
擟	𪭧
彌	弥
禰	祢
𥌃	𥅘
䕳	𦰴
𡄣	𠵸
𡾱	㟜
獼	猕
㜷	𡝠
䉲	𥮜
羋	芈
瀰	弥
祕	秘
覓	觅
覛	𫌪
冪	幂
謐	谧
綿	绵
緬	缅
鮸	𩾃
麫	面
麪	面
麵	面
鶓	鹋
緲	缈
𪃧	𫛹
廟	庙
繆	缪
滅	灭
闑	𫔶
衊	蔑
緍	𦈏
緡	缗
𪂆	𪉎
𩯁	𫙂
閔	闵
黽	黾
閩	闽
潣	𫞗
憫	悯
𥜐	𫀓
簢	𫂃
鰵	鳘
名覆金甌	名复金瓯
明覆	明复
明瞭	明了
鳴	鸣
銘	铭
𦡝	𫆫
謬	谬
謨	谟
嬤	嬷
饃	馍
歿	殁
縸	𫄲
鏌	镆
驀	蓦
侔德覆載	侔德复载
鉾	𫓴
謀	谋
嘸	呒
畝	亩
木吒	木吒
鉬	钼
樢	㭤
𩵦	𫠏
鎿	镎
哪吒	哪吒
吶	呐
納	纳
軜	𫐇
鈉	钠
𩚛	𩟿
䪏	𩏼
孻	𡥧
錼	镎
難	难
譨	𫍦
饢	馕
撓	挠
鐃	铙
堖	垴
惱	恼
腦	脑
䜀	䜧
鬧	闹
訥	讷
餒	馁
內	内
尼乾陀	尼乾陀
鈮	铌
輗	𫐐
鯢	鲵
𩸦	𩾆
齯	𫠜
擬	拟
𢣚	𢘝
膩	腻
鮎	鲇
鯰	鲶
輦	辇
攆	撵
𥗇	𪿵
躎	䟢
唸	念
釀	酿
鳥	鸟
裊	袅
嫋	袅
蔦	茑
𪈼	𪉓
隉	陧
錜	𫓻
聶	聂
嚙	啮
鎳	镍
籋	𥬞
櫱	蘖
齧	啮
囁	嗫
𡿖	𪩛
䌰	𦈙
躡	蹑
鑷	镊
顳	颞
䯀	䯅
䋻	䌾
甯	宁
寧	宁
薴	苧
嚀	咛
獰	狞
嬣	𪥰
檸	柠
聹	聍
䗿	𧉞
𧭈	𫍾
鸋	𫛢
擰	拧
𧩕	𫍭
濘	泞
紐	纽
鈕	钮
鈕釦	纽扣
農	农
儂	侬
蕽	𫇽
噥	哝
㺜	𪺻
濃	浓
憹	𢙐
膿	脓
燶	㶶
穠	秾
𨲳	𫔖
繷	𫄣
𨨢	𫓿
駑	驽
餪	𫗬
瘧	疟
儺	傩
㰙	𣗙
諾	诺
鍩	锘
釹	钕
漚	沤
甌	瓯
歐	欧
毆	殴
𥕥	𥐰
䙔	𫋲
謳	讴
鷗	鸥
嘔	呕
慪	怄
鈀	钯
盤	盘
蹣	蹒
詊	𫟟
彷	彷
彷彿	仿佛
龎	厐
龐	庞
鰟	鳑
拋	抛
皰	疱
礮	𪿫
賠	赔
錇	锫
轡	辔
噴	喷
濆	𣸣
鵬	鹏
紕	纰
𪄆	𪉔
鈹	铍
鮍	鲏
䴽	𫜔
羆	罴
𨵩	𨸆
闢	辟
鷿	䴙
駢	骈
𨵸	𨸇
𪘀	𪚏
𨭸	𫔐
諞	谝
騙	骗
縹	缥
飄	飘
𧢄	𫌬
𢣐	𪬚
䎙	𫅭
貧	贫
頻	频
嬪	嫔
矉	𪾸
蠙	𧏖
𧭹	𫍐
顰	颦
評	评
軿	𫐌
鮃	鲆
㵗	𣳆
憑	凭
憑藉	凭借
鵧	𫛨
蘋	苹
釙	钋
潑	泼
醱	酦
鏺	䥽
鉕	钷
駊	𫘟
頗	颇
頗覆	颇复
頮	颒
撲	扑
鋪	铺
鯆	𫚙
僕	仆
鏷	镤
樸	朴
譜	谱
鐠	镨
淒	凄
悽	凄
棲	栖
榿	桤
慼	戚
鏚	戚
祇	祇
旂	旗
棊	棋
碕	埼
頎	颀
齊	齐
騏	骐
騎	骑
臍	脐
䳢	𫛰
蘄	蕲
鯕	鲯
蠐	蛴
鰭	鳍
豈	岂
啟	启
啓	启
綺	绮
𨊰	䢀
氣	气
訖	讫
棄	弃
磧	碛
薺	荠
千鍾粟	千锺粟
釺	钎
牽	牵
鈆	𫓪
鉛	铅
僉	佥
慳	悭
鳽	𫛚
遷	迁
謙	谦
顅	𫖶
簽	签
鵮	鹐
鶼	鹣
籤	签
韆	千
乾	干
乾旦	乾旦
乾道	乾道
乾斷	乾断
乾綱	乾纲
乾卦	乾卦
乾紅	乾红
乾嘉	乾嘉
乾坤	乾坤
乾陵	乾陵
乾隆	乾隆
乾清宫	乾清宫
乾清宮	乾清宫
乾盛世	乾盛世
乾圖	乾图
乾縣	乾县
乾象	乾象
乾曜	乾曜
乾元	乾元
乾造	乾造
乾宅	乾宅
鈐	钤
鉗	钳
鉆	钻
蕁	荨
潛	潜
錢	钱
錢鍾書	钱锺书
騝	𩨃
騚	𩨊
淺	浅
繾	缱
譴	谴
塹	堑
槧	椠
縴	纤
鰜	鳒
瑲	玱
槍	枪
嶈	𡺃
戧	戗
錆	锖
鏘	锵
強	强
墻	墙
薔	蔷
廧	𪪞
嬙	嫱
檣	樯
牆	墙
搶	抢
羥	羟
繈	𫄶
鏹	镪
嗆	呛
熗	炝
蹌	跄
磽	硗
鍬	锹
蹺	跷
蹻	𫏋
喬	乔
僑	侨
蕎	荞
嘺	𪡀
嶠	峤
橋	桥
犞	𪺭
䱁	𫚏
礄	硚
䀉	𥁢
譙	谯
鐈	𫓱
鞽	鞒
殼	壳
誚	诮
㢗	𪪑
𠿕	𪜎
翹	翘
竅	窍
愜	惬
魥	𩽹
篋	箧
鍥	锲
竊	窃
嶔	嵚
駸	骎
𩎖	𫖑
寢	寝
鋟	锓
唚	吣
撳	揿
氫	氢
傾	倾
輕	轻
鶄	䴖
鯖	鲭
𨆪	𫏕
頃	顷
廎	庼
請	请
檾	𦼖
慶	庆
親	亲
㵾	𪷍
𡄔	𠴢
煢	茕
窮	穷
瓊	琼
藭	䓖
𪀖	𫛧
鞦	秋
鶖	鹙
鰍	鳅
鰌	䲡
虯	虬
釓	钆
釚	𫟲
巰	巯
賕	赇
銶	𨱇
鯄	𩾁
鰽	𫚧
區	区
詘	诎
䧢	𨸟
嶇	岖
誳	𫍮
𨧱	𨱊
趨	趋
麯	曲
軀	躯
麴	曲
驅	驱
鴝	鸲
𪁖	𪉌
詓	𫍜
齲	龋
闃	阒
覷	觑
駩	𩧴
𩣏	𩧶
輇	辁
詮	诠
銓	铨
鰁	鳈
權	权
顴	颧
綣	绻
勸	劝
𨶏	𨸊
闕	阙
卻	却
愨	悫
慤	悫
確	确
闋	阕
鵲	鹊
羣	群
䶲	𫜳
𩢡	𩧬
孃	娘
讓	让
嬈	娆
橈	桡
襓	𫋹
饒	饶
擾	扰
蟯	蛲
繞	绕
熱	热
䭃	𩠈
紉	纫
軔	轫
訒	讱
紝	纴
飪	饪
韌	韧
絍	𫟃
認	认
𧹈	𪥠
馹	驲
絨	绒
榮	荣
嶸	嵘
鎔	镕
爃	𫞡
蠑	蝾
輮	𫐓
鍒	𫔄
銣	铷
鴽	𫛪
繻	𦈡
顬	颥
縟	缛
軟	软
銳	锐
鋭	锐
閏	闰
潤	润
爇	𦶟
𠬙	𪠡
灑	洒
摋	𢫬
颯	飒
薩	萨
𥻦	𫂿
鰓	鳃
㘔	㗷
賽	赛
𣯶	毶
毿	毵
鬖	𩭹
傘	伞
糝	糁
鏾	𫔌
饊	馓
閐	𨸃
喪	丧
𦅇	𫄪
顙	颡
繅	缫
颾	𩙫
騷	骚
鰠	鳋
𩙈	𩙰
鱢	𫚫
掃	扫
嗇	啬
銫	铯
懎	𢠁
澀	涩
穡	穑
繬	𫄱
譅	䜧
飋	𫗋
槮	椮
篸	𥮾
剎	刹
挱	挲
殺	杀
紗	纱
樧	榝
魦	𫚌
鎩	铩
鯊	鲨
𧫝	𫍺
廈	厦
篩	筛
釃	酾
曬	晒
刪	删
姍	姗
軕	𫐅
釤	钐
穇	䅟
羶	膻
鱣	鳣
陝	陕
閃	闪
㪎	𪯋
熌	𤇄
訕	讪
銏	𫟶
樿	椫
謆	𫍸
䥇	䦂
繕	缮
騸	骟
贍	赡
鐥	䦅
鱔	鳝
傷	伤
傷亡枕藉	伤亡枕借
殤	殇
觴	觞
賞	赏
上鍊	上链
緔	绱
𧶧	䞎
燒	烧
紹	绍
輋	𪨶
賒	赊
捨	舍
厙	厍
射覆	射复
設	设
𤺔	𪽴
攝	摄
灄	滠
懾	慑
欇	𪳍
申覆	申复
紳	绅
詵	诜
蔘	参
幓	㡎
鰺	鲹
沈	沈
沈船	沉船
沈積	沉积
沈沒	沉没
沈默	沉默
諗	谂
審	审
瀋	沈
嬸	婶
讅	谉
甚鉅	甚钜
腎	肾
滲	渗
鋠	𫓵
瘮	瘆
昇	升
陞	升
聲	声
澠	渑
繩	绳
勝	胜
聖	圣
屍	尸
師	师
絁	𫄟
獅	狮
詩	诗
溼	湿
溮	浉
鳲	鸤
鳾	䴓
蝨	虱
濕	湿
鯴	鲺
鰤	𫚕
𥜰	𫀌
飠	饣
時	时
塒	埘
蒔	莳
𧵳	䞌
溡	𪶄
鉽	𫟸
蝕	蚀
實	实
識	识
鰣	鲥
駛	驶
示覆	示复
視	视
貰	贳
勢	势
軾	轼
鈰	铈
弒	弑
飾	饰
試	试
𩛌	𫗤
適	适
𨼳	𫔽
諡	谥
謚	谥
釋	释
手鍊	手链
壽	寿
綬	绶
獸	兽
鏉	𨱒
書	书
紓	纾
軗	𨐅
綀	𦈌
樞	枢
輸	输
𥊝	𥅿
攄	摅
䱙	𩾈
贖	赎
籔	䉤
屬	属
䙱	𧜭
朮	术
術	术
竪	竖
㜐	𫝧
豎	竖
數	数
樹	树
𠐊	𫝋
𡂡	𪢒
𧞫	𫌋
縗	缞
帥	帅
閂	闩
雙	双
騻	𫘭
孇	𪥫
𧕟	𧉐
䉶	𫁷
驦	骦
鸘	鹴
𨥟	𫓫
誰	谁
挩	捝
涗	涚
稅	税
順	顺
瞤	𥆧
說	说
説	说
碩	硕
鎙	𫔈
爍	烁
䁻	䀥
鑠	铄
俬	私
絲	丝
噝	咝
廝	厮
緦	缌
螄	蛳
鍶	锶
颸	飔
鷥	鸶
釲	𫟳
飼	饲
駟	驷
騃	𫘤
瀃	𣽷
鬆	松
㞞	𪨊
慫	怂
聳	耸
㩳	㧐
訟	讼
頌	颂
誦	诵
餸	𩠌
蒐	搜
鎪	锼
餿	馊
颼	飕
騪	𩨄
䱸	𫠑
謏	𫍲
擻	擞
藪	薮
甦	苏
穌	稣
蘇	苏
㢝	𢋈
囌	苏
泝	溯
素藉	素借
訴	诉
遡	溯
肅	肃
鋉	𨱈
餗	𫗧
㩋	𪮋
潚	㴋
𦃩	𫄯
謖	谡
𩘹	𩙨
驌	骕
鷫	鹔
痠	酸
蒜薹	蒜薹
雖	虽
綏	绥
隨	随
嵗	岁
歲	岁
𡻕	岁
誶	谇
繐	穗
繸	䍁
䡵	𫟦
孫	孙
蓀	荪
猻	狲
筍	笋
損	损
簑	蓑
縮	缩
嗩	唢
瑣	琐
鎍	𫔅
鎖	锁
鎖鍊	锁链
𩘝	𩙭
𨶀	𨸉
獺	獭
𩥑	𩨌
鰨	鳎
㒓	𠉂
撻	挞
澾	㳠
䌈	𦈖
闒	阘
𦪙	䑽
闥	闼
𤒻	𪹹
臺	台
颱	台
駘	骀
鮐	鲐
擡	抬
薹	苔
檯	台
鈦	钛
態	态
貪	贪
嘽	啴
攤	摊
灘	滩
癱	瘫
墰	坛
談	谈
壇	坛
曇	昙
𨨏	𬭛
顃	𩖖
罈	坛
壜	坛
譚	谭
䜖	𫟢
罎	坛
鉭	钽
𨅍	𨁴
嘆	叹
歎	叹
賧	赕
湯	汤
劏	㓥
醣	糖
餳	饧
鏜	镗
𥼽	𥹥
鎲	镋
儻	傥
钂	镋
燙	烫
鐋	铴
絛	绦
𩎢	𩏾
縧	绦
濤	涛
燾	焘
韜	韬
鞀	鼗
綯	绹
騊	𫘦
檮	梼
䬞	𩙧
討	讨
鋱	铽
蟘	𫋌
謄	誊
騰	腾
鰧	䲢
銻	锑
鷈	䴘
鷉	䴘
綈	绨
緹	缇
題	题
鵜	鹈
騠	𫘨
鶗	𫛸
鯷	鳀
鷤	𫛴
體	体
屜	屉
殢	𣨼
𧎈	𧌥
靝	靔
𨌈	𫐍
闐	阗
賟	𧹖
覥	觍
靦	腼
𩞯	䭪
條	条
蓧	𦰏
樤	𣔌
齠	龆
鰷	鲦
誂	𫍥
頫	𫖯
糶	粜
貼	贴
鐵	铁
鐵鍊	铁链
䴴	𪎋
烴	烃
䋼	𫄮
聽	听
廳	厅
𨳑	𨸁
頲	颋
衕	同
絧	𫄡
詷	𫍣
銅	铜
鮦	鲖
統	统
慟	恸
鍮	𨱎
緰	𦈕
頭	头
鈄	钭
禿	秃
鵚	𪉍
鈯	𨱄
塗	涂
圖	图
䳜	𫛬
釷	钍
𩸃	𩾅
摶	抟
蓴	莼
團	团
槫	𣏢
𩜵	𩠊
糰	团
頹	颓
頽	颓
𥢢	䅪
𩘺	𩙬
㿗	𤻊
蛻	蜕
飩	饨
魨	鲀
託	托
飥	饦
脫	脱
䴱	𫜒
𡹬	𪨹
䡐	𫟤
詑	𫍡
馱	驮
鉈	铊
駞	𫘞
駝	驼
鴕	鸵
鼉	鼍
橢	椭
籜	箨
媧	娲
窪	洼
譁	哗
膃	腽
襪	袜
咼	呙
喎	㖞
彎	弯
壪	塆
灣	湾
𨈊	𨂺
紈	纨
頑	顽
輓	挽
綰	绾
𩣵	𩧻
萬	万
萬鍾	万锺
贃	𧹗
䥑	鿏
網	网
輞	辋
誷	𫍬
瀇	㲿
䋿	𦈓
癐	𤶊
鰃	鳂
為	为
韋	韦
幃	帏
圍	围
爲	为
溈	沩
湋	𣲗
違	违
維	维
撝	㧑
潿	涠
潙	沩
闈	闱
濰	潍
覹	𫌭
䥩	𨱖
偽	伪
偉	伟
𢯷	𪭝
蒍	𫇭
葦	苇
瑋	玮
椲	㭏
煒	炜
僞	伪
蔿	𫇭
𥯤	𫁳
諉	诿
緯	纬
薳	䓕
鮪	鲔
韙	韪
䪘	𩏿
磑	硙
蝟	猬
衛	卫
餧	𫗪
謂	谓
懀	𢙓
餵	喂
轊	𫐕
𩤸	𩨅
𧔥	𧒭
𥶽	𫁱
䲁	鳚
䵳	𪑅
溫	温
榲	榅
𪉸	𫜊
鰛	鳁
鰮	鳁
文錦覆阱	文锦复阱
紋	纹
馼	𫘜
聞	闻
鳼	𪉃
閿	阌
䦟	䦷
穩	稳
問	问
搵	揾
鶲	鹟
甕	瓮
堝	埚
萵	莴
渦	涡
窩	窝
撾	挝
蝸	蜗
臥	卧
𩸡	𫚟
齷	龌
烏	乌
𠌥	𠆿
𠞆	𠛆
鄔	邬
嗚	呜
誣	诬
𣽏	𪶮
鴮	𫛦
鎢	钨
吳	吴
無	无
墲	𪢸
蕪	芜
鵐	鹀
䉑	𫁲
熓	𤆡
廡	庑
潕	𣲘
憮	怃
嫵	妩
鵡	鹉
悞	悮
務	务
塢	坞
誤	误
霧	雾
騖	骛
鶩	鹜
餏	饻
誒	诶
錫	锡
譆	𫍻
犧	牺
鸂	㶉
鑴	𫔔
習	习
蓆	席
覡	觋
騱	𫘬
鰼	鳛
襲	袭
驨	𫘱
銑	铣
𨧀	𬭊
諰	𫍰
縰	𫄳
璽	玺
瓕	𤦀
係	系
釳	𨰿
鈒	钑
細	细
㑶	㐹
綌	绤
熂	𪸕
戱	戯
戲	戏
鬩	阋
餼	饩
霼	𪵣
蝦	虾
鰕	𫚥
俠	侠
峽	峡
狹	狭
硤	硖
轄	辖
䪗	𩐀
嚇	吓
杴	锨
秈	籼
銛	铦
薟	莶
鍁	锨
錟	锬
憸	𪫺
鮮	鲜
㷿	𤈷
躚	跹
纖	纤
𨇤	𫏨
絃	弦
閑	闲
閒	闲
銜	衔
撏	挦
賢	贤
嫻	娴
𡢃	㛠
嫺	娴
諴	𫍯
癇	痫
鷴	鹇
鷳	鹇
蜆	蚬
險	险
嶮	崄
獫	猃
獮	狝
蘚	藓
玁	𤞤
顯	显
俔	伣
莧	苋
哯	𠯟
峴	岘
現	现
睍	𪾢
羨	羡
䦘	𨸄
綫	线
撊	𪭾
線	线
縣	县
餡	馅
憲	宪
𩤊	𩧩
麲	𪎉
獻	献
𨏥	𨐊
鄉	乡
廂	厢
薌	芗
緗	缃
鑲	镶
驤	骧
詳	详
餉	饷
鮝	鲞
蠁	蚃
鯗	鲞
饗	飨
響	响
饟	𫗵
項	项
項鍊	项链
曏	向
嚮	向
䦳	𨷿
梟	枭
綃	绡
嘵	哓
𨴹	𫔲
銷	销
𧜗	䘞
蕭	萧
蕭乾	萧乾
鴞	鸮
蟂	𫋇
鵁	䴔
簫	箫
䬘	𩙮
譊	𫍢
瀟	潇
𤑳	𤎻
囂	嚣
驍	骁
蠨	蟏
毊	𪵑
曉	晓
篠	筿
嘯	啸
斅	𢽾
斆	敩
蠍	蝎
協	协
挾	挟
脅	胁
頡	颉
諧	谐
擷	撷
攜	携
纈	缬
寫	写
䥱	䥾
洩	泄
屓	屃
紲	绁
緤	𫄬
謝	谢
褻	亵
瀉	泻
訢	䜣
鋅	锌
𩖰	𫠇
鐔	镡
釁	衅
𦂅	𦈒
騂	骍
鈃	钘
鉶	铏
𥸠	𥮋
倖	幸
興	兴
兇	凶
洶	汹
訩	讻
𩿅	𫠖
詗	诇
脩	修
鵂	鸺
饈	馐
綇	𦈋
綉	绣
銹	锈
鏥	𫔊
繡	绣
鏽	锈
虛	虚
須	须
頊	顼
噓	嘘
嬃	媭
諝	谞
𩓣	𩖕
䱬	𩾊
鬚	须
㑯	㑔
詡	诩
盨	𪾔
𩝔	𩠋
卹	恤
敘	叙
銊	𫓰
漵	溆
緒	绪
續	续
鱮	𫚈
軒	轩
𣈶	暅
諼	谖
譞	𫍽
旋乾轉坤	旋乾转坤
䮄	𫠊
懸	悬
選	选
癬	癣
絢	绚
鉉	铉
镟	旋
繏	𦈝
鏇	镟
鐶	镮
鞾	𫖇
踅門瞭戶	踅门了户
嶨	峃
學	学
澩	泶
鷽	鸴
鱈	鳕
謔	谑
勛	勋
塤	埙
勳	勋
壎	埙
薰	薰
燻	熏
纁	𫄸
尋	寻
㜄	㚯
詢	询
噚	㖊
潯	浔
樳	桪
𦠅	𫞅
蟳	𫊻
鱘	鲟
訓	训
訊	讯
馴	驯
遜	逊
䭀	𩠇
愻	𢙏
𩷰	𩾄
椏	桠
鴉	鸦
鴨	鸭
壓	压
啞	哑
瘂	痖
亞	亚
軋	轧
埡	垭
掗	挜
𡸗	𪨩
訝	讶
婭	娅
氬	氩
𥏝	𪿊
稏	䅉
錏	铔
齾	𫜰
菸	烟
煙	烟
醃	腌
閹	阉
懨	恹
訁	讠
閆	闫
綖	𫄧
閻	阎
顏	颜
顔	颜
嚴	严
巖	岩
巗	𪨷
鹽	盐
兗	兖
菴	庵
噞	𪡋
𡽗	𡸃
厴	厣
䱧	𫚠
鰋	𫚢
龑	䶮
儼	俨
鼴	鼹
魘	魇
巘	𪩘
齴	𫜮
黶	黡
彥	彦
覎	觃
硯	砚
雁杳魚沈	雁杳鱼沉
厭	厌
䛳	𫍫
諺	谚
鴳	𫛩
贋	赝
嚥	咽
騴	𫘫
醶	𫑷
贗	赝
驗	验
饜	餍
讌	䜩
艷	艳
釅	酽
讞	谳
灧	滟
豔	艳
灩	滟
鉠	𫓭
鴦	鸯
䱀	𫚐
陽	阳
揚	扬
瑒	玚
楊	杨
暘	旸
煬	炀
瘍	疡
鍚	钖
颺	飏
鰑	𫚊
養	养
駚	𩧫
癢	痒
樣	样
幺麼	幺麽
訞	𫍚
堯	尧
軺	轺
搖	摇
遙	遥
瑤	瑶
銚	铫
蕘	荛
嶢	峣
窯	窑
餚	肴
謡	谣
謠	谣
颻	飖
鰩	鳐
齩	𫜪
葯	药
鈅	钥
藥	药
鷂	鹞
鑰	钥
𨶮	𨸌
釾	䥺
爺	爷
鋣	铘
頁	页
葉	叶
業	业
曄	晔
燁	烨
鄴	邺
謁	谒
擫	𢬍
饁	馌
靨	靥
禕	祎
銥	铱
褘	袆
醫	医
貽	贻
𧦧	𫍟
詒	诒
飴	饴
遺	遗
儀	仪
頤	颐
彞	彝
以功覆過	以功复过
釔	钇
𩛆	𩠂
輢	𫐎
錡	锜
礒	𥐟
蟻	蚁
顗	𫖮
艤	舣
𨣞	𨟳
𩡣	𩡖
靉	叆
異	异
軼	轶
鈠	𨱁
䋚	䌻
詣	诣
義	义
勩	勚
䴬	𪎈
䭿	𩧭
億	亿
誼	谊
瘞	瘗
𢍰	𪪴
嶧	峄
瘱	𪽷
𣿉	𣶫
懌	怿
憶	忆
縊	缢
藝	艺
鎰	镒
繹	绎
繶	𫄷
譯	译
議	议
𤑹	𪹀
鷊	鹝
囈	呓
鐿	镱
鷁	鹢
鷖	鹥
驛	驿
茵藉	茵借
陰	阴
蔭	荫
銦	铟
緸	𦈑
駰	骃
欽	钦
銀	银
銀鍊	银链
誾	訚
檭	𣘴
齦	龈
鷣	𫜃
飲	饮
隱	隐
蘟	𦻕
齗	龂
䌥	𦈠
癮	瘾
𪘯	𪚐
猌	𪺽
廕	荫
憖	慭
鮣	䲟
緓	绬
鍈	锳
罃	䓨
嬰	婴
攖	撄
罌	罂
嚶	嘤
孾	𪧀
孆	𫝭
瓔	璎
櫻	樱
鶯	莺
纓	缨
鷹	鹰
鸚	鹦
塋	茔
滎	荥
熒	荧
瑩	莹
螢	萤
營	营
縈	萦
濚	溁
鎣	蓥
蠅	蝇
瀠	潆
贏	赢
潁	颍
頴	颕
穎	颖
巊	𪩎
癭	瘿
𣋋	𣈣
應	应
瀅	滢
䵴	𫜙
喲	哟
傭	佣
擁	拥
鏞	镛
鱅	鳙
癰	痈
鰫	𫚦
詠	咏
湧	涌
踴	踊
鯒	鲬
醟	蒏
憂	忧
優	优
𥴼	𫁺
𩽇	𩾎
郵	邮
猶	犹
遊	游
鈾	铀
蕕	莸
魷	鱿
鮋	鲉
銪	铕
誘	诱
於	于
於敖	於敖
於崇文	於崇文
於單	於单
於乎	於乎
於呼哀哉	於呼哀哉
於梨華	於梨华
於琳	於琳
於陵子	於陵子
於倫	於伦
於穆	於穆
於其一	於其一
於清言	於清言
於世成	於世成
於坦	於坦
於菟	於菟
於惟一	於惟一
於戲	於戏
於邑	於邑
於勇明	於勇明
於則	於则
於忠祥	於忠祥
於仲完	於仲完
於竹屋	於竹屋
紆	纡
汙	污
娛	娱
魚	鱼
𨦫	䦀
漁	渔
餘	余
諛	谀
踰	逾
覦	觎
璵	玙
輿	舆
歟	欤
顒	颙
騟	𩨈
籅	𥫣
𪃍	𪉐
䱷	䲣
俁	俣
𨋢	䢂
與	与
傴	伛
語	语
鋙	铻
𦟼	𫆝
嶼	屿
㦛	𢗓
齬	龉
馭	驭
飫	饫
鈺	钰
䫻	𫗇
預	预
獄	狱
嫗	妪
慾	欲
蕷	蓣
閾	阈
閼	阏
鴥	𫛣
錥	𫓾
諭	谕
澦	滪
禦	御
鵒	鹆
癒	愈
譽	誉
𧟀	𧝧
鱊	𫚪
鷸	鹬
軉	𨉗
鬱	郁
籲	吁
淵	渊
鳶	鸢
鴛	鸳
鵷	鹓
員	员
䬧	𫗟
園	园
圓	圆
緣	缘
黿	鼋
轅	辕
櫞	橼
騵	𫘪
鶰	𫛫
䛄	𫍠
遠	远
願	愿
約	约
彠	彟
軏	𫐄
悅	悦
𨊸	䢁
𨳕	𨸀
粵	粤
鉞	钺
閱	阅
閲	阅
樂	乐
嶽	岳
𩓥	𫖵
躍	跃
躒	跞
𨷲	𨸎
蒕	蒀
暈	晕
氳	氲
輼	辒
頵	𫖳
轀	辒
贇	赟
勻	匀
紜	纭
雲	云
鄖	郧
㜏	㛣
熉	𤈶
蕓	芸
蕓薹	芸薹
澐	沄
篔	筼
䉙	𥬀
鈗	𫟵
隕	陨
溳	涢
殞	殒
霣	𫕥
貟	贠
鄆	郓
惲	恽
運	运
腪	𣍯
慍	愠
熅	煴
䲰	𪉂
𤸫	𤶧
緼	缊
薀	蕰
醖	酝
縕	缊
醞	酝
醞藉	酝借
餫	𫗥
藴	蕴
韞	韫
蘊	蕴
韻	韵
鉔	𫓬
臢	臜
雜	杂
災	灾
載	载
儎	傤
攢	攒
趲	趱
暫	暂
蹔	𫏐
鏨	錾
贊	赞
酇	酂
灒	𪷽
瓚	瓒
𩯳	𩯒
讚	赞
贓	赃
髒	脏
贜	赃
駔	驵
臟	脏
鑿	凿
棗	枣
𨎮	𨐉
繰	缲
皁	皂
譟	噪
竈	灶
則	则
責	责
嘖	啧
幘	帻
擇	择
皟	𤾀
𤢟	𤝢
澤	泽
簀	箦
賾	赜
襗	𫋷
蘀	萚
𩔳	𫖴
齰	𫜬
賊	贼
鰂	鲗
譖	谮
鋥	锃
繒	缯
贈	赠
吒	咤
紮	扎
囃	𠱞
齇	齄
閘	闸
𩿤	𫛠
鍘	铡
鮺	鲝
柵	栅
詐	诈
鮓	鲊
𩶱	𩽽
齋	斋
𩏪	𩏽
債	债
飦	𫗞
詀	𧮪
氈	毡
譫	谵
饘	𫗴
驙	𫘰
鸇	鹯
斬	斩
盞	盏
嶄	崭
颭	飐
䁪	𥇢
輾	辗
𨭖	𫔑
佔	占
棧	栈
綻	绽
嶘	𡺄
戰	战
𩥇	𩨍
驏	骣
張	张
張法乾	张法乾
餦	𫗠
鱆	𫠒
𪅂	𫜂
漲	涨
鞝	绱
帳	帐
脹	胀
痮	𪽪
賬	账
釗	钊
詔	诏
趙	赵
𩘀	𩙩
摺	折
輒	辄
蟄	蛰
鮿	𫚚
謫	谪
轍	辙
䮰	𫘮
讋	詟
襵	𫌇
鍺	锗
這	这
鷓	鹧
貞	贞
針	针
眞	真
偵	侦
湞	浈
楨	桢
鉁	𨱅
禎	祯
鍼	针
𪇳	𪉕
軫	轸
診	诊
䪴	𫖫
䪾	𫖬
縝	缜
陣	阵
紖	纼
賑	赈
誫	𫍨
鴆	鸩
㓄	𪠟
鎮	镇
鎭	镇
爭	争
掙	挣
崢	峥
猙	狰
睜	睁
鉦	钲
箏	筝
錚	铮
癥	症
幀	帧
証	证
諍	诤
䦛	䦶
鄭	郑
證	证
𩏠	𫖖
衹	衹
衹得	只得
衹見樹木	只见树木
隻	只
梔	栀
鳷	𫛛
鴲	𪉆
𩶰	𩽿
織	织
執	执
縶	絷
職	职
躑	踯
紙	纸
訨	𫟞
軹	轵
徵	征
徵調	徵调
徵聲	徵声
徵弦	徵弦
徵絃	徵弦
徵音	徵音
𨎌	𫐋
輊	轾
製	制
銍	铚
誌	志
滯	滞
𡠹	㛿
摯	挚
幟	帜
質	质
駤	𫘠
㘉	𠰱
緻	致
擲	掷
櫛	栉
𤛱	𫞢
𨟊	𫟬
贄	贽
䦯	𫔵
觶	觯
騭	骘
鷙	鸷
躓	踬
鑕	锧
𨤻	𨤰
終	终
鈡	钟
鍾	钟
鍾鍛	锺锻
鍾馗	锺馗
鍾萬梅	锺万梅
鍾重發	锺重发
鐘	钟
塚	冢
腫	肿
種	种
重覆	重复
眾	众
衆	众
諥	𫍳
𧬤	𫍼
䱰	𩾋
週	周
輈	辀
銂	𫟻
輖	𫐏
賙	赒
𩢸	𩧳
鵃	鸼
謅	诌
譸	诪
𨰃	𫔉
軸	轴
鯞	𫚡
冑	胄
紂	纣
晝	昼
葤	荮
㑳	㑇
㥮	㤘
駎	𩧨
皺	皱
縐	绉
驟	骤
硃	朱
誅	诛
銖	铢
豬	猪
諸	诸
藷	𫉄
瀦	潴
㶆	𫞛
櫧	槠
櫫	橥
騶	驺
燭	烛
劚	㔉
孎	𡠟
欘	𣚚
爥	𪹳
斸	𣃁
蠾	𧑏
䠱	𨅛
囑	嘱
矚	瞩
佇	伫
苧	苎
眝	𪾣
竚	𥩟
紵	纻
貯	贮
註	注
駐	驻
築	筑
鑄	铸
專	专
鄟	𫑘
膞	䏝
磚	砖
諯	𫍱
顓	颛
鱄	𫚋
竱	𫁟
賺	赚
縳	䌸
轉	转
饌	馔
囀	啭
妝	妆
莊	庄
裝	装
樁	桩
𪁈	𪉉
𥵃	𥱔
壯	壮
狀	状
戇	戆
錐	锥
騅	骓
墜	坠
綴	缀
縋	缒
贅	赘
諄	谆
準	准
鐯	䦃
梲	棁
諑	诼
濁	浊
𧜵	䙊
鵫	𫛱
鐲	镯
茲	兹
䊷	䌶
貲	赀
資	资
緇	缁
輜	辎
錙	锱
諮	咨
澬	𫞚
鎡	镃
鯔	鲻
鰦	𫚤
齜	龇
釨	𫓦
眥	眦
漬	渍
綜	综
騌	骔
豵	𫎆
蹤	踪
傯	偬
總	总
糉	粽
錝	𫓽
瘲	疭
縱	纵
鄒	邹
諏	诹
鯫	鲰
𨧰	𫟽
𨩰	𫟾
鏃	镞
組	组
詛	诅
謯	𫍹
躦	躜
㸇	𤎺
䂎	𥎝
纘	缵
鑽	钻
纗	𫄹
鐏	𨱔
鱒	鳟
鷷	𫜄
繓	𦈛
飵	𫗢
龭	𩨎
龯	𨱆
鿁	䜤
𠁞	𠀾
𠗣	㓆
𠽃	𪠺
𡅏	𠲥
𡅯	𪢖
𡑭	𡋗
𡓁	𪤄
𡓾	𡋀
𡔖	𡍣
𡞵	㛟
𡮉	𡭜
𡮣	𡭬
𡳳	𡳃
𢣭	𢘞
𢶫	𢫞
𢷮	𢫊
𢹿	𢬦
𢺳	𪮳
𣍐	𠊉
𣙎	㭣
𣠩	𣞎
𣠲	𣑶
𣾷	㳢
𤅶	𣷷
𤒎	𤊀
𤓌	𪹠
𤓩	𤊰
𤜆	𪺪
𤠮	𪺸
𤢻	𢢐
𤪺	㻘
𤬅	𪼴
𩻬	𫚩
𩻮	𫚘
𩼶	𫚬
𪋿	𪎍
𪟖	𠛾
𪷓	𣶭
𫒡	𫓷
𫜦	𫜫